+--+--+--+--+--+--+
|.    .     .     |
+  +--+  +  +--+  +
|.  |  .  |  .   .|
+  +  +--+--+  +  +
|.  |  .    c  |  |
+  +--+  +--+  +--+
|.     . |  |    .|
+--+  +--+  +--+--+
|.    r   .    .  |
+--+--+--+--+--+--+