+--+--+--+--+--+--+
|.        .       |
+  +--+  +  +--+  +
|.  |     |      .|
+  +  +--+--+  +  +
|.  |  .    c  |  |
+  +--+  +--+  +--+
|.     . |  |    .|
+--+  +--+  +--+--+
|.    .   .    r  |
+--+--+--+--+--+--+